1 1 1 1 1 1 1 1 1 1 1 1 1 1 1 1 1 1 1 1 1 1 1 1 1 1 1 1 1 2 2 2 2 2 2 1 1 1 1 1 1 1 1 1 1 1 1 1 1 1
1 1 9 9 9 9 1 6 1 9 9 9 9 9 9 9 1 6 5 5 5 6 6 5 5 5 6 5 5 2 2 2 2 2 2 5 0 0 1 9 9 9 9 9 9 9 9 9 9 1
1 1 9 9 9 9 1 5 1 9 9 9 9 9 9 9 1 6 5 6 5 5 5 6 6 5 6 6 5 2 2 2 2 2 4 0 0 0 1 9 9 9 9 9 9 9 9 9 9 1
1 1 9 9 9 9 1 0 1 9 9 9 9 9 9 9 1 0 0 0 0 0 0 0 0 0 3 4 2 2 2 2 2 4 3 0 0 0 1 9 9 9 9 9 9 9 9 9 9 1
1 1 9 9 9 9 1 0 1 9 9 9 9 9 9 9 1 0 0 0 0 0 5 0 0 3 4 2 2 2 2 2 2 4 3 0 0 7 1 9 9 9 9 9 9 9 9 9 9 1
1 1 1 1 1 9 1 0 1 1 1 1 1 1 1 9 1 0 0 0 0 0 0 0 3 4 2 2 2 2 2 2 4 3 5 0 0 7 1 1 1 1 1 1 1 1 9 1 1 1
1 6 5 0 0 0 0 0 0 0 0 0 0 0 0 0 0 0 0 0 0 0 0 3 4 2 2 2 2 2 2 2 4 5 5 5 5 5 5 0 0 0 0 0 0 0 0 0 0 1
1 1 1 1 1 1 1 8 0 0 0 0 0 0 0 0 0 0 0 0 0 0 0 9 9 9 9 9 9 9 9 9 3 0 0 0 0 0 0 0 0 0 0 0 0 0 0 0 0 1
1 9 9 9 9 9 1 8 8 0 0 0 0 0 0 0 0 0 0 0 0 0 0 9 9 9 9 9 9 9 9 3 0 0 0 0 0 0 0 0 0 0 0 0 0 0 0 0 0 1
1 9 9 9 9 9 9 0 0 0 0 0 0 0 0 0 0 0 0 0 0 0 9 9 9 9 9 9 9 9 3 0 0 0 0 0 0 0 0 0 0 0 0 0 0 0 0 0 0 1
1 9 9 9 9 9 9 8 8 0 0 0 0 0 0 0 0 0 3 4 4 2 2 2 2 2 2 2 3 5 5 5 5 5 5 5 5 5 5 0 6 5 0 0 0 0 0 0 0 1
1 9 9 9 9 9 1 8 0 0 0 0 0 0 0 0 0 3 4 4 2 2 2 2 2 2 2 4 0 5 5 5 5 0 0 0 0 0 5 0 0 5 0 0 0 0 0 0 0 1
1 9 9 9 9 9 1 7 0 0 0 0 0 0 0 0 3 4 4 2 2 2 2 2 2 2 0 0 5 5 0 5 0 0 7 0 0 0 5 0 0 5 0 0 0 0 7 7 0 1
1 9 9 9 9 9 1 7 0 0 0 0 0 0 0 3 4 2 2 2 2 2 2 2 2 0 0 0 5 6 0 0 0 0 0 0 0 0 5 0 7 5 0 0 0 0 7 7 0 1
1 9 9 9 9 9 1 8 0 0 0 0 0 0 3 4 2 2 2 2 2 2 2 2 0 0 0 0 5 5 5 0 0 0 8 0 0 7 5 0 0 5 0 7 0 0 0 0 0 1
1 1 1 1 1 1 1 7 0 0 3 3 3 3 4 2 2 2 2 2 2 2 2 4 0 0 0 6 6 5 0 0 7 0 0 0 0 0 5 0 0 5 0 0 0 6 0 0 0 1
1 5 5 8 7 7 8 8 3 3 4 4 4 4 2 2 2 2 2 2 2 2 4 3 5 6 6 5 5 6 0 0 0 0 0 7 0 0 5 0 8 5 0 0 0 0 0 0 0 1
1 6 5 0 0 0 0 3 4 4 4 2 2 2 2 2 2 2 2 2 2 4 3 5 5 5 5 6 7 7 0 0 0 0 0 0 0 0 5 0 8 5 0 8 0 0 8 0 0 1
1 5 5 0 0 0 3 4 4 2 2 2 2 2 2 2 2 2 2 2 4 3 0 0 0 0 0 7 0 0 0 0 0 8 0 0 8 5 0 0 0 5 0 0 0 7 0 0 2 1
1 6 6 0 3 3 4 2 2 2 2 2 2 2 2 2 2 2 2 4 3 0 0 8 0 0 8 0 8 0 0 0 0 7 0 0 5 0 0 0 6 5 0 0 0 0 0 2 2 1
1 5 6 3 4 4 2 2 2 2 2 2 2 2 2 2 2 2 4 3 0 0 8 0 0 0 0 7 0 7 0 0 0 0 0 5 7 0 0 0 7 0 5 0 0 0 2 2 2 1
1 3 3 4 4 2 2 2 2 2 2 2 2 2 2 2 2 4 3 0 0 0 0 0 0 0 7 0 0 0 0 8 0 0 5 0 0 0 0 0 0 0 0 5 0 2 2 2 2 1
1 4 4 4 2 2 2 2 2 2 2 2 2 2 2 2 4 3 0 0 0 0 0 7 7 0 0 0 7 0 0 0 0 5 0 0 0 0 0 0 0 0 0 0 2 2 2 2 2 1
1 2 2 2 2 2 2 2 2 2 2 2 2 4 4 4 3 0 0 0 7 0 0 8 0 0 0 0 0 0 7 0 5 0 0 0 0 7 0 0 0 0 7 0 2 2 2 2 2 1
2 2 2 2 2 2 2 2 2 2 4 4 4 3 3 3 0 0 0 0 0 7 8 0 0 7 5 5 6 5 5 5 0 0 8 0 0 0 0 0 7 0 0 5 2 2 2 6 2 1
2 2 2 2 0 2 2 4 4 4 3 3 3 3 0 0 0 0 0 0 0 0 0 0 5 5 0 0 0 0 0 8 7 0 0 0 0 0 0 0 0 0 0 0 2 2 2 2 2 1
2 2 2 2 2 4 3 3 3 3 3 0 0 0 0 0 7 0 8 0 8 0 0 5 5 0 0 5 5 5 5 0 7 0 7 0 0 0 7 0 0 0 0 0 0 2 2 2 2 1
1 4 4 4 3 3 3 0 0 0 0 0 0 0 0 0 0 0 0 0 0 5 5 5 8 7 5 0 0 0 0 5 0 0 8 0 0 0 0 0 0 5 0 0 0 0 2 2 2 1
1 3 3 3 3 0 0 0 5 5 5 5 5 5 5 5 5 5 5 5 5 5 0 0 7 5 0 0 0 0 8 7 0 0 0 0 0 0 0 0 0 0 5 0 0 0 0 2 2 1
1 0 0 0 0 0 6 0 0 0 0 0 0 0 0 8 0 0 0 0 0 0 0 0 5 0 8 0 0 0 7 8 0 8 0 0 8 0 0 0 0 0 0 5 0 0 0 0 0 1
1 0 0 0 0 0 5 5 5 5 5 5 5 5 5 5 5 5 5 5 5 5 5 5 0 7 0 7 0 0 0 0 0 0 0 0 0 0 0 0 0 0 0 0 5 5 0 0 0 1
1 1 1 1 1 1 0 0 0 0 5 0 0 0 7 5 0 0 7 7 0 0 0 0 8 0 0 0 8 0 0 0 0 8 7 0 8 8 0 8 0 0 0 0 0 5 0 0 0 1
1 9 9 9 9 1 0 0 0 0 0 0 0 0 8 8 0 0 0 0 0 0 0 7 0 0 7 0 0 7 0 0 0 8 8 0 0 0 0 0 0 8 0 0 0 5 0 7 0 1
1 9 9 9 9 9 0 0 0 0 0 0 6 0 8 0 0 0 0 0 0 0 8 0 0 0 0 0 0 0 8 0 0 0 0 0 0 0 0 0 0 0 0 0 7 5 0 0 0 1
1 9 9 9 9 1 0 0 5 0 0 0 0 0 0 7 0 0 0 0 0 7 0 0 0 0 8 0 7 0 0 7 0 0 0 0 0 8 0 7 0 0 0 0 0 5 0 0 0 1
1 1 1 1 1 1 0 0 0 8 0 0 0 0 0 0 0 0 0 0 8 0 0 0 7 0 0 0 0 0 0 0 8 0 0 0 0 0 0 0 0 0 8 0 0 5 0 0 0 1
1 0 7 0 0 0 0 0 0 0 0 0 0 0 0 0 0 0 0 7 0 0 0 0 0 8 0 7 0 8 0 0 0 7 0 0 0 0 0 8 0 7 0 0 7 5 0 7 0 1
1 0 0 7 0 0 0 0 0 0 5 0 5 5 5 5 5 5 5 5 5 5 5 5 5 5 5 5 5 5 0 0 0 0 7 0 0 0 0 0 0 0 8 0 5 0 0 0 0 1
1 0 0 0 8 0 5 0 8 0 0 5 0 0 0 0 0 7 0 0 0 0 7 8 8 0 8 0 0 0 7 0 0 0 0 8 0 0 0 0 0 0 0 5 0 7 0 0 0 1
1 1 1 1 1 1 1 1 1 0 5 0 5 0 0 0 8 8 0 0 0 0 7 8 7 0 0 0 0 7 0 0 0 0 0 8 7 0 0 0 0 0 5 0 0 0 0 0 0 1
1 9 9 9 9 9 9 9 1 5 0 0 0 0 0 8 0 0 8 0 0 0 0 8 0 0 0 0 8 0 0 0 0 0 0 0 7 8 0 0 0 5 7 0 0 0 0 0 0 1
1 9 9 9 9 9 9 9 9 0 0 0 0 0 7 0 0 0 0 8 0 8 0 0 0 0 0 0 0 0 8 0 0 0 0 0 0 7 7 0 0 5 0 0 1 1 1 1 1 1
1 9 9 9 9 9 9 9 9 0 0 0 0 5 0 0 0 0 0 0 8 0 0 8 0 8 0 0 0 8 0 0 0 8 0 0 0 0 7 7 0 5 0 0 9 9 9 9 1 1
1 9 9 9 9 9 9 9 1 7 0 0 8 0 0 0 8 0 0 0 0 0 0 0 0 0 0 0 7 0 0 0 7 0 0 0 0 0 0 7 8 5 0 0 1 9 9 9 1 1
1 9 9 9 9 1 1 1 1 0 0 6 7 8 0 0 0 0 8 0 0 0 0 0 7 0 0 0 0 0 0 0 0 0 7 0 0 0 0 8 7 5 0 0 1 9 9 9 1 1
1 9 9 9 9 1 9 9 1 0 7 0 8 0 0 0 7 0 0 0 0 8 0 0 0 0 0 0 0 0 0 0 7 0 0 0 8 0 0 0 0 5 7 0 1 9 9 9 1 1
1 9 9 9 9 1 9 9 1 8 0 0 0 0 7 0 0 0 0 0 7 0 0 0 8 0 0 0 0 0 0 0 0 0 0 0 0 0 0 7 8 5 8 7 1 9 9 9 1 1
1 9 9 9 9 9 9 9 1 0 0 0 0 0 0 0 0 0 0 0 0 0 0 0 0 0 0 8 0 0 0 0 0 0 0 8 7 0 0 0 0 5 0 8 1 1 1 1 1 1
1 9 9 9 9 9 9 9 1 0 0 0 5 0 0 0 0 0 0 0 0 0 0 0 0 0 0 0 0 0 8 7 0 0 0 0 0 0 8 0 0 5 0 0 7 8 7 8 8 1
1 1 1 1 1 1 1 1 1 1 1 1 1 1 1 1 1 1 1 1 1 1 1 1 1 1 1 1 1 1 1 1 1 1 1 1 1 1 1 1 1 1 1 1 1 1 1 1 1 1
